C3 V2 __  C3 V2 __  C3 V2 __  C3 __ __  C3 __ __  C3 __ __
W2 __ __  __ __ __  __ __ W2  __ __ __  __ __ __  __ __ __
F6 __ __  F6 __ __  F6 __ __  F6 __ __  F6 __ __  F6 __ __

C3 __ __  C3 __ __  C3 __ __  C3 W1 __  C3 W1 __  C3 W1 __
W2 __ __  __ S1 __  __ __ W2  W1 __ __  __ __ __  __ __ V1
F6 __ __  F6 W1 __  F6 __ __  F6 __ __  F6 __ __  F6 __ __

C3 __ __  C3 V1 __  C3 __ __  C3 __ __  C3 __ __  C3 __ __
W2 __ __  __ __ __  __ __ W2  W1 __ __  __ __ __  __ __ V1
F6 __ __  F6 __ __  F6 __ __  F6 __ __  F6 __ __  F6 __ __

C3 __ __  C3 __ __  C3 __ __  C3 __ __  C3 __ __  C3 __ __
W2 __ __  __ @n __  __ __ __  __ __ __  __ __ __  __ __ V1
F6 W2 __  F6 W2 __  F6 W2 __  F6 W1 __  F6 W1 __  F6 W1 __