__ V2 __  __ V2 __  __ V2 __  __ __ __  __ __ __  __ __ __
W2 __ __  __ __ __  __ __ W2  __ __ __  __ __ __  __ __ __
__ __ __  __ __ __  __ __ __  __ __ __  __ __ __  __ __ __

__ __ __  __ __ __  __ __ __  __ W1 __  __ W1 __  __ W1 __
W2 __ __  __ __ __  __ __ W2  W1 __ __  __ __ __  __ __ V1
__ __ __  __ W1 __  __ __ __  __ __ __  __ __ __  __ __ __

__ __ __  __ V1 __  __ __ __  __ __ __  __ __ __  __ __ __
W2 __ __  __ __ __  __ __ W2  W1 __ __  __ __ __  __ __ V1
__ __ __  __ __ __  __ __ __  __ __ __  __ __ __  __ __ __

__ __ __  __ __ __  __ __ __  __ __ __  __ __ __  __ __ __
W2 __ __  __ @n __  __ __ __  __ __ __  __ __ __  __ __ V1
__ W2 __  __ W2 __  __ W2 __  __ W1 __  __ W1 __  __ W1 __